0 0 0 0 0 0 0 0 0 0 0 0 0 0 0 4
0 0 0 0 0 0 0 0 0 0 0 0 11 0 0 4
0 0 5 0 0 0 0 0 0 0 0 1 2 3 0 4
0 0 5 0 5 5 0 0 0 0 0 7 8 9 0 4
0 0 5 0 5 0 0 0 0 0 0 0 0 0 0 4
0 0 5 5 5 0 0 0 0 0 0 0 0 0 0 4
0 0 0 0 0 0 1 2 2 3 0 0 0 0 0 4
0 0 0 0 0 0 0 0 0 0 0 0 0 0 0 4
10 0 0 0 0 0 0 0 0 0 0 0 0 0 0 4