20 11
15 15 15 15 15 15 15 15 51 15 15 15 15 15 15 15 15 15 15 15
15 71 72 73 0  0  0  15 0  0  0  0  0  0  0  0  0  0  0  15
15 74 22 75 0  0  0  15 67 0  0  0  0  0  0  0  0  0  23 15
15 15 15 15 15 0  0  15 15 15 15 15 15 0  0  0  0  0  0  15
15 0  0  0  0  0  0  0 15  0  0  0  15 0  0  0  0  0  0  15
15 0  0  0  0  0  0  15 0  0  0  0  15 0  0  0  0  0  0  15
15 0  0  0  0  0  51 15 0  0  0  0  15 0  15 15 15 15 15 15
15 0  15 11 12 12 13 15 0  0  81 0  0  0  0  0  0  0  0  15
15 0  0  17 18 18 19 0  0  0  0  0  0  0  0  0  67 0  0  15
15 0  0  0  0  0  0  0  0  0  0  0  0  0  51 0  0  0  0  15
15 15 15 15 15 15 15 15 15 15 15 15 15 15 51 15 15 15 15 15
