20 11
15 15 15 15 15 15 15 50 15 15 15 15 15 15 15 15 15 15 15 15
15 0  71 72 73 0  0  0  15 51 0  0  0  0  0  0  0  0  0  15
15 60 74 22 75 0  0  0  15 0  0  0  0  0  82 0  0  0  0  15
15 15 15 15 15 0  0  0  15 0  0  15 0  0  0  0  0  0  0  15
15 15 15 15 15 0  0  0  15 0  0  15 0  0  0  0  0  0  0  15
15 0  0  0  0  0  0  0  15 0  21 15 0  0  0  0  0  0  0  15
15 0  0  0  0  0  0  0  15 15 15 15 15 15 15 15 15 0  67 15
15 0  0  11 12 12 13 15 0  0  0  0  51 51 51 51 50 0  0  15
15 0  0  17 18 18 19 0  0  0  0  60 0  0  0  0  0  0  0  15
15 0  0  0  0  0  0  0  0  0  0  0  0  0  0  0  0  0  0  15
15 51 51 15 15 15 15 15 15 15 15 15 51 51 51 51 51 51 51 15
