20 11
15 15 15 15 15 15 15 15 15 15 15 15 15 15 15 15 15 15 15 15
15 0  0  0  15 0  0  0  0  0  0  0  0  0  0  0  0  0  0  15
15 0  21 0  0  0  0  0  0  0  0  15 15 15 15 15 15 15 0  15
15 15 15 15 15 0  0  0  0  0  0  15 0  0  0  0  24 15 0  15
15 0  0  0  0  0  0  0  0  0  0  15 0  0  15 15 15 15 0  15
15 0  0  0  0  0  0  0  0  0  0  15 0  0  0  0  0  0  0  15
15 0  0  22 0  0  0  0  0  0  0  15 15 15 15 15 15 15 15 15
15 0  15 11 12 12 13 15 0  0  0  0  0  0  15 0  0  0  0  15
15 0  0  17 18 18 19 0  0  0  0  0  15 0  15 0  15 0  0  15
15 0  0  0  0  0  0  0  0  0  0  0  15 0  0  0  15 0  23 15
15 15 15 15 15 15 15 15 15 15 15 15 15 15 15 15 15 15 15 15