20 11
15 15 15 15 15 15 15 15 50 15 15 15 15 15 15 15 15 15 15 15
15 71 72 73  0  0  0  0  0  0  0  0  0  0  0  0  0  0  0 15
15 74 22 75  0  0  0  0  0  0  0  0  0  0  0 51  0  0 23 15
15 15 15 15 15  0  0  51 0  0 15 15  0  0 15  0  0  0 15 15
15  0  0  0  0  0  0  0  0  0  0  0  0  0 15  0  0  0  0 15
15  0  81 0  0  0  0  0 52  0  0  0  0  0  0  0  0  0  0 15
15  0  0  0 15  0  0  51 51 0  0 51  0  0  0 15  0  0  0 15
15  0  0  0 15  0  0  0  0 51  0  0  0  0 15  0  0  0  0 15
15  0 15 11 12 12 13  0  0  0  0  0  0 15  0  0  0  81 0 15
15  0 67 0  0  50 19  0  0  0  0  0  0  0  0  0  0  0  0 15
15 15 15 15 15 15 15 15 15 15 15 15 15 15 15 15 15 15 15 15
