20 13
15 15 15 15 15 15 15 15 51 15 15 15 15 15 15 15 15 15 15 15
15 0  0  0  0  0  0  15 0  0  0  0  0  0  0  0  0  0  0  15
15 0  0 0  0  0  0  15 0  0  50 0  0  0  0  0  0  0  21  15
15 15 15 15 15 0  0  15 15 15 15 15 15 0  0  0  0  0  0  15
15 0  0  0  0  0  0  0 15  0  0  0  15 0  0  0  0  0  0  15
15 0  0  0  0  0  0  15 0  51 0  0  15 0  0  0  0  0  0  15
15 0  0  22 0  0  0  15 0  0  0  0  15 0 15 15 15 15 15 15
15 0  15 11 12 12 13 15 0  0  0  0  0  0  0  0  0  0  0  15
15 0  0  17 18 18 19 0  0  0  0  0  0  50 0  0  0  0  0  15
15 0  0  0  0  0  0  0  15 15 15 15 15 15 15 0  0  0  0  15
15 0  0  0  0  0  0  0  0  0  0  0  0  0  51 0  0  0  0  15
15 0  0  0  0  0  0  0  0  0  0  0  0  0  50 0  15 0  0  15
15 15 15 15 15 15 15 15 15 15 15 15 15 15 15 15 15 15 15 15