20 11
15 15 15 15 15 15 15 15 15 15 15 15 15 15 15 15 15 15 15 15
15 23 0  0  0  0  0  0  0  0  51 51 51 51 50 51 51 0  0  15
15 11 12 12 13 0  0  0  0  0  0  0  0  0  0  0  0  0  0  15
15 14 15 15 16 0  0  0  0  51 51 51 14 15 15 16 0  0  0  15
15 0  0  0  0  0  0  0  0  15 15 15 0  0  0  0  0  0  0  15
15 60 0  0  0  0  0  0  0  15 0  0  0  0  0  0  60 0  0  15
15 17 18 18 19 0  0  0  0  51 0  0  0  17 18 18 19 0  0  15
15 0  0  0  0  0  0  0  0  0  0  0  0  0  0  0  0  0  0  15
15 0  0  0  0  81 0  0  0  51 0  0  0  0  0  0  82 0  0  15
15 0  0  0  0  0  0  0  0  15 0  0  0  0  0  0  0  0  69 15
15 15 15 15 15 15 15 15 15 15 15 15 15 15 15 15 15 15 15 15
