20 11
15 15 15 15 15 15 15 15 15 15 15 15 15 15 15 15 15 15 15 15
15 11 12 13 51 15 51 15 50 15 51 15 51 15 51 15 51 15 51 15
15 14 15 16  0  0  0  0 81  0  0  0  0  0  0  0  0  0 23 15
15 17 18 19  0  0  0  0  0  0  15 15 15 15 15 0 15 15 15 15
15 51 51 50  0  0  0  0  0  0  0  0  0  0  0  0 15 50 82 15
15  0  0  0  0  51 0  0  0  0  51 15 15 51 15 15 15 0  0 15
15  0  0  0  0  51 0  0  0  0  0  0  0  0  0  0  0  0  0 15
15  0 60  0  0  0  0  0  0  0  0  0  0  0  0  0  0  0  0 15
15  0 15 17 18 19  0  0 51 51 51 51  0  0 51 51 51 51 69 15
15  0  0  0  0  0  0  0 51 51 51 51  0  0 51 51 51 51 15 15
15 15 15 15 15 15 15 15 15 15 15 15 15 15 15 15 15 15 15 15


