20 11
15 15 15 15 15 15 15 15 15 15 15 15 15 15 15 15 15 15 15 15
15 0  0  0  0  0  0  0  0  0  0  0  0  0  0  0  0  0  0  15
15 0  0  0  0  0  0  0  0  0  0  0  0  0  0  0  0  0  0  15
15 0  0  0  0  0  0  0  0  0  0  0  0  0  0  0  0  21 0  15
15 0  0  0  0  0  0  0  0  0  0  0  0  0  0  0  0  0  0  15
15 0  0  0  0  0  0  0  11 12 13 14 15 0  0  0  0  0  0  15
15 0  0  0  0  0  0  0  15 15 12 11 12 0  0  0  0  0  0  15
15 0  0  0  0  0  0  0  0  0  0  0  0  0  0  0  0  0  0  15
15 0  0  0  0  0  0  0  0  0  0  0  0  0  0  0  0  0  0  15
15 0  0  0  0  0  0  0  0  0  0  0  0  0  0  0  0  0  0  15
15 15 15 15 15 15 15 15 15 15 15 15 15 15 15 15 15 15 15 15
