20 11
15 15 15 15 15 15 15 15 15 15 15 15 15 15 15 15 15 15 15 15
15 0  0  0  0  0  0  0  0  0  0  0  0  0  0  0  0  0  0  15
15 0  15 15 15 15 0  0  0  0  0  0  15 15 15 15 15 0  0  15
15 0  15 0  0  0  0  0  0  0  0  0  0  0  0  0  15 0  0  15
15 0  15 0  0  0  0  15 15 15 0  0  0  0  0  0  15 0  0  15
15 0  15 0  22 0  0  0  0  15 0  0  0  24 0  0  15 0  0  15
15 0  15 15 15 15 15 15 0  15 0  0  15 15 15 15 15 0  0  15
15 0  0  0  0  0  0  0  0  15 0  0  0  0  0  0  0  0  0  15
15 0  0  0  15 15 15 15 15 15 0  0  0  15 15 15 15 15 0  15
15 0  0  0  0  0  0  0  0  0  0  0  0  0  0  0  0  0  0  15
15 15 15 15 15 15 15 15 15 15 15 15 15 15 15 15 15 15 15 15