20
11
10 11 11 10 10 10 10 10 10 10 10 10 10 10 10 10 10 10 10 10
11 0 0 0 0 0 0 0 0 0 0 0 0 0 0 0 0 0 0 12
14 0 0 0 0 0 0 0 0 0 0 0 0 0 0 0 0 0 0 10
11 0 0 0 0 0 0 0 0 0 0 0 0 0 0 0 0 0 0 15
12 0 0 0 0 0 0 0 0 0 0 0 0 0 0 0 0 0 0 15
13 0 0 0 0 0 0 0 1 1 1 0 0 0 0 0 0 0 0 10
14 0 0 0 0 0 0 0 0 0 0 0 0 0 0 0 0 0 0 10
10 0 0 0 0 0 0 0 0 0 0 0 0 0 0 0 0 0 0 10
15 0 0 0 0 0 0 0 0 0 0 0 0 0 0 0 0 0 0 10
14 0 0 0 0 0 0 0 0 0 0 0 0 0 0 0 0 0 0 12
10 12 10 10 11 10 10 13 14 10 10 10 10 10 10 10 11 15 12 12