20 11
15 15 15 15 15 15 15 15 15 15 15 15 15 15 15 15 15 15 15 15
15 0  0  0  0  0  0  0  0  0  0  0  0  0  0  0  71 72 73 15
15 0  60 15 0  0  0  0  0  0  0  0  15 0  0  0  74 21 75 15
15 15 15 15 15 15 0  0  0  0  0  0  15 15 15 15 15 15 15 15
15 0  81 0  0  0  0  0  0  0  0  0  0  0  0  0  0  0  0  15
15 0  0  0  0  0  0  0  0  0  15 0  0  0  0  0  0  0  0  15
15 0  11 12 12 12 13 0  0  0  15 15 15 15 0  15 15 0  0  15
15 0  17 18 18 18 19 0  0  0  0  0  0  15 0  0  15 15 15 15
15 0  0  0  0  0  0  0  0  0  0  0  0  0  0  0  0  0  0  15
15 0  0  0  0  0  0  0  0  0  0  0  0  0  0  0  0  0  0  15
15 15 15 15 15 15 15 15 15 15 15 15 15 15 15 15 15 15 15 15